tileswide 56
tileshigh 34
tilewidth 32
tileheight 32

layer 0
32,4,33,34,5,25,34,5,25,34,5,25,34,5,25,34,5,25,34,5,25,34,5,25,34,5,25,34,5,25,34,5,25,34,5,25,34,5,25,34,5,25,34,5,25,34,5,25,34,5,34,5,33,34,5,33,
34,5,25,29,26,35,29,26,35,29,26,35,29,26,35,29,26,35,29,26,35,29,26,35,29,26,35,29,26,35,29,26,35,29,26,35,29,26,35,29,26,35,29,26,35,29,26,35,29,26,29,26,35,29,26,35,
29,26,35,40,16,16,16,16,16,16,42,32,4,33,32,4,33,32,4,33,32,4,33,32,4,33,32,4,33,32,4,33,32,4,33,32,4,33,32,4,33,32,40,16,16,16,16,16,16,42,32,4,33,32,4,33,
32,4,40,24,0,14,14,0,0,0,17,34,5,25,34,5,25,34,5,25,34,5,25,34,5,25,34,5,25,34,5,25,34,5,25,34,5,25,34,5,25,34,19,0,0,0,0,0,0,17,34,5,25,34,5,25,
34,5,19,0,0,14,14,0,0,0,17,29,26,35,29,26,35,29,26,35,29,26,35,40,16,16,16,16,16,16,16,42,29,26,35,29,26,35,29,26,35,40,24,0,0,0,0,0,0,17,29,26,35,29,26,35,
29,26,19,0,0,14,14,0,0,0,17,32,4,33,32,4,33,32,4,33,32,40,16,24,0,0,0,0,0,0,0,15,42,26,35,29,26,35,29,26,40,24,0,0,14,14,14,14,14,17,32,4,33,32,4,33,
32,4,19,0,0,14,14,0,0,0,17,34,5,25,34,5,25,34,5,25,34,19,0,14,14,14,14,14,14,14,14,0,15,16,16,16,16,16,16,16,24,0,0,0,0,0,0,0,0,17,34,5,25,34,5,25,
34,5,19,0,0,14,14,0,0,0,17,29,26,35,29,26,35,29,26,35,29,19,0,14,14,14,14,14,14,14,14,0,0,0,0,0,0,0,0,0,0,0,0,0,0,0,0,0,0,17,29,26,35,29,26,35,
29,26,19,0,0,14,14,0,0,0,17,32,4,33,32,4,33,32,4,33,32,19,0,0,0,0,0,0,0,0,0,0,0,0,0,0,0,0,0,0,0,0,0,0,0,0,0,0,0,15,42,4,33,32,4,33,
32,4,19,0,0,14,14,0,0,0,15,42,5,25,34,5,25,34,5,25,34,19,0,0,21,18,18,18,18,20,0,0,0,0,0,0,0,0,0,0,0,0,0,0,0,0,0,0,0,0,15,42,32,29,26,35,
34,5,19,0,0,14,14,0,0,0,0,15,42,35,29,26,35,29,26,35,29,39,18,18,41,32,4,33,32,19,0,0,0,0,0,0,0,0,0,0,0,0,0,0,0,0,0,0,0,0,0,15,16,42,4,33,
29,26,19,0,0,14,14,0,0,0,0,0,15,42,32,4,33,32,4,33,32,4,33,32,4,33,32,4,33,19,0,0,0,0,0,0,0,0,0,0,0,0,0,0,0,0,0,0,0,0,0,0,0,17,5,25,
29,26,19,0,0,14,14,0,0,0,0,0,0,17,34,5,25,34,5,25,34,5,25,34,5,25,34,5,25,19,0,0,0,0,0,0,0,0,0,0,0,0,0,0,0,0,0,0,0,0,0,0,0,17,26,35,
32,4,19,0,0,14,0,0,0,0,0,0,0,17,29,26,35,29,26,35,29,26,35,29,26,35,29,26,40,24,0,0,0,0,0,0,0,0,0,0,0,0,0,0,0,0,0,0,0,0,0,0,0,17,4,33,
34,5,19,0,0,0,0,0,0,0,0,0,0,17,32,4,33,32,4,33,32,40,16,16,16,16,16,16,24,0,0,0,0,0,0,0,0,0,0,0,0,0,0,0,0,0,0,0,0,0,0,0,0,17,5,25,
29,26,39,18,20,0,0,0,0,0,0,0,0,17,34,5,25,34,5,25,34,19,0,0,0,0,0,0,0,0,0,0,0,0,0,0,0,0,0,0,0,0,0,0,0,0,0,0,0,0,0,0,0,17,26,35,
4,33,34,26,19,0,0,0,0,0,0,0,0,15,42,29,35,29,26,35,29,19,0,0,0,0,0,0,0,0,0,0,0,0,0,0,0,0,0,0,0,0,0,0,0,0,0,0,0,0,0,0,0,17,4,33,
5,34,34,40,24,0,0,0,0,0,0,0,0,0,15,42,35,32,4,33,40,24,0,0,0,0,0,0,0,0,0,0,0,0,0,0,0,0,0,0,0,0,0,0,0,0,0,0,0,0,0,0,0,17,5,25,
32,26,34,19,0,0,0,0,0,0,0,0,0,0,0,15,42,34,5,40,24,0,0,0,0,0,0,0,0,0,0,0,0,0,0,0,0,21,18,18,18,18,20,0,0,0,0,0,0,0,0,0,0,17,26,35,
25,34,34,19,0,0,0,0,0,0,0,0,0,0,0,0,15,16,16,24,0,0,0,0,0,0,0,0,0,0,0,0,0,0,0,0,21,41,32,4,33,32,39,20,0,0,0,0,0,0,0,0,0,17,4,33,
26,26,34,19,0,0,0,0,0,0,0,0,0,0,0,0,0,0,0,0,0,0,0,0,0,0,0,0,0,0,0,0,0,0,0,0,41,25,34,5,25,34,5,19,0,0,0,0,0,0,0,0,0,17,5,25,
35,34,40,24,0,0,0,0,0,0,0,0,0,0,0,0,0,0,0,0,0,0,0,0,0,0,0,0,0,0,0,0,0,0,0,17,29,25,29,26,35,29,26,19,0,0,0,0,0,0,0,0,0,17,26,35,
33,34,19,0,0,0,0,0,0,0,0,0,0,0,0,0,0,0,0,0,0,0,0,0,0,0,0,0,0,0,0,0,0,0,0,17,32,4,32,4,33,32,4,19,0,0,14,14,0,0,0,0,0,17,4,33,
32,26,19,14,14,14,14,14,14,14,14,14,14,14,14,14,14,14,14,14,14,14,14,14,0,0,0,0,0,0,0,0,0,0,0,17,29,25,34,5,25,34,5,19,0,0,14,14,0,0,0,0,21,41,5,25,
32,26,19,14,14,14,14,14,14,14,14,14,14,14,14,14,14,14,14,14,14,14,14,14,14,0,0,0,0,0,0,0,0,0,0,15,42,32,29,26,35,29,26,19,0,0,14,14,0,0,0,21,41,26,35,34,
33,26,19,0,0,0,0,0,0,0,0,0,0,0,0,0,0,0,0,0,0,0,0,0,0,0,0,0,0,0,0,0,0,0,0,0,17,33,32,4,33,32,4,19,0,0,14,14,0,0,0,17,32,4,33,32,
32,34,39,18,20,0,0,0,0,0,0,0,0,0,0,0,0,0,0,20,0,0,0,0,0,0,0,0,0,0,0,0,0,0,0,0,17,25,34,5,25,34,5,19,0,0,14,14,0,0,0,17,34,5,25,34,
32,33,4,35,19,0,0,0,0,0,0,0,0,0,0,0,0,0,0,0,0,0,0,0,0,0,0,0,0,0,0,0,0,0,0,0,17,35,29,26,35,29,26,19,0,0,14,14,0,0,0,17,29,26,35,29,
33,34,32,33,19,0,0,0,0,0,0,0,0,0,0,0,0,0,0,24,0,0,0,0,0,0,0,0,0,0,0,0,0,0,0,0,17,33,32,4,33,40,16,24,0,0,14,14,0,0,0,17,32,4,33,32,
33,34,32,4,19,0,0,0,0,0,0,0,0,0,0,0,0,0,0,0,0,0,0,0,0,0,0,0,0,0,0,0,0,0,0,0,17,25,34,5,25,39,18,18,18,18,18,18,18,18,18,41,34,5,25,34,
32,25,33,32,39,18,18,18,18,18,18,18,18,18,20,0,0,0,0,0,0,0,21,18,18,18,18,18,18,18,18,18,18,18,18,18,41,35,29,26,35,29,26,35,29,26,35,29,26,35,29,26,35,29,26,35,
5,34,34,25,5,25,34,25,5,25,34,33,5,25,39,18,18,18,18,18,18,18,41,33,4,34,33,4,34,33,4,34,33,4,34,33,4,33,32,4,33,32,4,33,32,4,33,32,4,33,32,26,33,32,4,33,
25,25,5,25,5,25,34,5,25,5,25,32,4,33,4,33,29,26,35,4,34,5,25,35,5,29,25,5,29,25,5,29,25,5,29,25,5,25,34,5,25,34,5,25,34,5,25,34,5,25,34,5,25,34,5,25,
32,25,33,32,5,25,25,29,25,25,25,34,25,5,33,29,5,25,25,33,34,5,33,29,25,5,33,25,5,25,29,33,33,5,35,5,34,25,25,35,35,25,35,33,4,4,29,33,26,4,4,35,25,29,4,4,

layer 1
0,0,0,0,0,0,0,0,0,0,0,0,0,0,0,0,0,0,0,0,0,0,0,0,0,0,0,0,0,0,0,0,0,0,0,0,0,0,0,0,0,0,0,0,0,6,6,6,0,0,0,0,0,0,0,0,
0,6,6,6,6,6,6,6,6,6,6,6,0,0,0,0,0,0,0,0,0,0,0,0,0,0,0,0,0,0,0,0,0,0,0,0,0,0,0,0,0,6,6,6,6,6,6,6,6,6,6,0,0,0,0,0,
0,6,6,0,0,0,0,0,0,0,0,6,0,0,0,0,0,0,0,0,0,0,0,0,6,6,6,6,0,0,0,0,0,0,0,0,0,0,0,0,0,6,0,0,0,0,0,0,0,0,6,0,0,0,0,0,
0,6,0,0,0,0,0,0,0,0,0,6,0,0,0,0,0,0,0,0,0,0,6,6,6,6,6,6,6,6,6,6,6,0,0,0,0,0,0,0,6,6,0,0,0,0,0,0,0,0,6,0,0,0,0,0,
0,6,0,0,0,0,0,0,0,0,0,6,0,0,0,0,0,0,0,0,6,6,6,0,0,0,0,0,0,0,0,0,6,6,0,0,0,0,0,6,6,0,0,0,0,0,0,0,0,0,6,0,0,0,0,0,
0,6,0,0,0,0,0,0,0,0,0,6,0,0,0,0,0,0,0,0,6,0,0,0,0,0,0,0,0,0,0,0,0,6,6,6,6,6,6,6,0,0,0,0,0,0,0,0,0,0,6,0,0,0,0,0,
0,6,0,0,0,0,0,0,0,0,0,6,0,0,0,0,0,0,0,6,6,0,0,0,0,0,0,0,0,0,0,0,0,0,0,0,0,0,0,0,0,0,0,0,0,0,0,0,0,0,6,0,0,0,0,0,
0,6,0,0,0,0,0,0,0,0,0,6,0,0,0,0,0,0,0,6,6,0,0,0,0,0,0,0,0,0,0,0,0,0,0,0,0,0,0,0,0,0,0,0,0,0,0,0,0,0,6,6,0,0,0,0,
0,6,0,0,0,0,0,0,0,0,0,6,6,0,0,0,0,0,0,6,6,0,0,0,0,0,0,0,0,0,0,0,0,0,0,0,0,0,0,0,0,0,0,0,0,0,0,0,0,0,0,6,6,0,0,0,
6,6,0,0,0,0,0,0,0,0,0,0,6,6,0,0,0,0,0,6,6,0,0,0,0,0,0,0,0,0,0,0,0,0,0,0,0,0,0,0,0,0,0,0,0,0,0,0,0,0,0,0,6,6,6,0,
6,6,0,0,0,0,0,0,0,0,0,0,0,6,6,0,0,0,0,6,6,0,0,0,0,6,6,6,6,0,0,0,0,0,0,0,0,0,0,0,0,0,0,0,0,0,0,0,0,0,0,0,0,0,6,0,
0,6,0,0,0,0,0,0,0,0,0,0,0,0,6,0,0,0,0,0,6,6,6,6,6,6,0,0,6,0,0,0,0,0,0,0,0,0,0,0,0,0,0,0,0,0,0,0,0,0,0,0,0,0,6,0,
6,6,0,0,0,0,0,0,0,0,0,0,0,0,6,0,0,0,0,0,0,0,0,0,0,0,0,6,6,0,0,0,0,0,0,0,0,0,0,0,0,0,0,0,0,0,0,0,0,0,0,0,0,0,6,0,
6,6,0,0,0,0,0,0,0,0,0,0,0,0,6,0,0,0,0,0,6,6,6,6,6,6,6,6,0,0,0,0,0,0,0,0,0,0,0,0,0,0,0,0,0,0,0,0,0,0,0,0,0,0,6,0,
6,6,0,0,0,0,0,0,0,0,0,0,0,0,6,0,0,0,0,0,6,0,0,0,0,0,0,0,0,0,0,0,0,0,0,0,0,0,0,0,0,0,0,0,0,0,0,0,0,0,0,0,0,0,6,0,
0,6,0,0,0,0,0,0,0,0,0,0,0,0,6,6,0,0,0,0,6,0,0,0,0,0,0,0,0,0,0,0,0,0,0,0,0,0,0,0,0,0,0,0,0,0,0,0,0,0,0,0,0,0,6,0,
0,6,6,6,0,0,0,0,0,0,0,0,0,0,0,6,6,0,0,6,6,0,0,0,0,0,0,0,0,0,0,0,0,0,0,0,0,0,0,0,0,0,0,0,0,0,0,0,0,0,0,0,0,0,6,0,
0,6,6,0,0,0,0,0,0,0,0,0,0,0,0,0,6,6,6,6,0,0,0,0,0,0,0,0,0,0,0,0,0,0,0,0,0,0,0,0,0,0,0,0,0,0,0,0,0,0,0,0,0,0,6,0,
0,0,6,0,0,0,0,0,0,0,0,0,0,0,0,0,0,6,6,0,0,0,0,0,0,0,0,0,0,0,0,0,0,0,0,0,0,0,0,0,0,0,0,0,0,0,0,0,0,0,0,0,0,0,6,0,
0,0,6,0,0,0,0,0,0,0,0,0,0,0,0,0,0,0,0,0,0,0,0,0,0,0,0,0,0,0,0,0,0,0,0,0,0,0,6,6,6,6,0,0,0,0,0,0,0,0,0,0,0,0,6,0,
6,6,6,0,0,0,0,0,0,0,0,0,0,0,0,0,0,0,0,0,0,0,0,0,0,0,0,0,0,0,0,0,0,0,0,0,0,6,6,0,0,6,6,0,0,0,0,0,0,0,0,0,0,0,6,0,
6,6,0,0,0,0,0,0,0,0,0,0,0,0,0,0,0,0,0,0,0,0,0,0,0,0,0,0,0,0,0,0,0,0,0,0,6,6,0,0,0,0,6,0,0,0,0,0,0,0,0,0,0,0,6,0,
6,6,0,0,0,0,0,0,0,0,0,0,0,0,0,0,0,0,0,0,0,0,0,0,0,0,0,0,0,0,0,0,0,0,0,0,6,0,0,0,0,0,6,0,0,0,0,0,0,0,0,0,0,0,6,0,
6,6,0,0,0,0,0,0,0,0,0,0,0,0,0,0,0,0,0,0,0,0,0,0,0,0,0,0,0,0,0,0,0,0,0,0,6,6,0,0,0,0,6,0,0,0,0,0,0,0,0,0,0,0,6,0,
6,6,0,0,0,0,0,0,0,0,0,0,0,0,0,0,0,0,0,0,0,0,0,0,0,0,0,0,0,0,0,0,0,0,0,0,0,6,0,0,0,0,6,0,0,0,0,0,0,0,0,0,0,6,6,0,
6,6,0,0,0,0,0,0,0,0,0,0,0,0,0,0,0,0,0,0,0,0,0,0,0,0,0,0,0,0,0,0,0,0,0,0,0,6,0,0,0,0,6,0,0,0,0,0,0,0,0,0,6,6,0,0,
0,6,0,0,0,0,0,0,0,0,0,0,0,0,0,0,0,0,0,0,0,0,0,0,0,0,0,0,0,0,0,0,0,0,0,0,0,6,0,0,0,6,6,0,0,0,0,0,0,0,0,0,6,0,0,0,
0,6,6,6,0,0,0,0,0,0,0,0,0,0,0,0,0,0,0,0,0,0,0,0,0,0,0,0,0,0,0,0,0,0,0,0,0,6,0,0,6,6,6,0,0,0,0,0,0,0,0,0,6,0,0,0,
0,0,0,6,0,0,0,0,0,0,0,0,0,0,0,0,0,0,0,0,0,0,0,0,0,0,0,0,0,0,0,0,0,0,0,0,0,6,0,0,6,0,0,0,0,0,0,0,0,0,0,0,6,0,0,0,
0,0,6,6,0,0,0,0,0,0,0,0,0,0,0,0,0,0,0,0,0,0,0,0,0,0,0,0,0,0,0,0,0,0,0,0,0,6,0,0,6,0,0,0,0,0,0,0,0,0,0,0,6,0,0,0,
0,0,0,6,0,0,0,0,0,0,0,0,0,0,0,0,0,0,0,0,0,0,0,0,0,0,0,0,0,0,0,0,0,0,0,0,0,6,0,0,6,6,6,6,6,6,6,6,6,6,6,6,6,0,0,0,
0,0,0,6,6,6,6,6,6,6,6,6,6,6,0,0,0,0,0,0,0,0,0,6,6,6,6,6,6,6,6,6,6,6,6,6,6,6,0,0,0,0,0,0,0,0,0,0,6,6,6,6,6,0,0,0,
0,0,0,0,0,0,0,0,0,0,0,0,0,6,6,6,6,6,6,6,6,6,6,6,0,0,0,0,0,0,0,0,0,0,0,0,0,0,0,0,0,0,0,0,0,0,0,0,0,0,0,0,0,0,0,0,
0,0,0,0,0,0,0,0,0,0,0,0,0,0,0,0,0,0,0,0,0,0,0,0,0,0,0,0,0,0,0,0,0,0,0,0,0,0,0,0,0,0,0,0,0,0,0,0,0,0,0,0,0,0,0,0,

